000000000000000000000000000000000000000000000000000000000000
000000000000000000000000000000000000000000001100000000000000
000000000000000000000000000000000000000000001100000000000000
000000000011111111110000000011000000000000001100000000110000
000000000011111111110000000011000000000000001100000000110000
001100000000000000000000000011000000000000001100000000110000
001100000000000000000000000011000000000000001100000000110000
001100000000000000000000000011000000000000001100000000110000
001100000000000000000000000011000000000000001100000000110000
001100000000000000000000000011000000000000001100000000110000
001100000000000000000000110011000000000000001100000000110000
001100000000000000000000110011000011000000000000000000110000
001100001100000000000000110011000011000000000000000000110000
001100001100000011000000110011000011000000000000000000110000
001100001100000011000000110011000011000011111111110000110000
001100001100000011000000110011000011000011111111110000110000
001100001100000011000000110011000011000000000000000000110000
001100001100000011001100110011000011000000000000000000110000
001100001100000011001100110000000011000000000000000000110000
001100001100000011001100110000000011000000000000000000110000
000000001100000011001100110000000011000000000000000000110000
000000001100000011001100110000000000000000000000000000110000
000000001100000011001100110000000000001111111111000000110000
000000001100000000001100110000000000001111111111000000000000
000000001100000000001100110000000000000000000000000000000000
000000001100000000001100000000000000000000000000000000000000
000000001100000000001100000000000000000000000000000000000000
000000000000000000000000000000000000000000000000000000000000
000000000000000000000000000000000000000000000000000000000000
000000000000000000000000000000000000000000000000000000000000
