000000000000000000000000
000000000000111100000000
000000000000111100000001
000001100000000000000001
000001100111111111000000
000001100111111111000000
000001100000000000000000
000001100000000000000000
